0,0,0,0,0,0,0,0
1,1,2,1,2,1,1,2
5,5,5,5,5,5,5,5
6,5,7,8,9,8,7,10
1,1,1,1,1,1,1,1
54,4,4,4,4,4,4,4
